v < < d < ! < <
v # # v ! # # ^
! # # ! ^ # # ^
v ! < . . ! < l
r > ! . . > ! ^
v # # v ! # # !
! # # ! ^ # # ^
v ! < . . ! < l
r > ! . . > ! ^
v # # v ! # # !
v # # ! ^ # # ^
> > ! > u > > ^