          }o{_______________o
          /   |              |
_________/____|       911    |
| __o_|     |        _____   |
|/ ___ \    |       / ___ \] |
[]_/.-.\_\__|______/_/.-.\_\[]
   |(O)|             |(O)|
