                                                                                            |..|                               |..|
                                                                                            |..|                               |..|
                                                                                            |..|                               |..|
                                                                                            |..|                               |..|
                                                                                            |..|                               |..|
                                                                                            |..|                               |..|
                                                                                            |..|                               |..|
                                                                                            |..|                               |..|
                                                                                            |..|                               |..|
                                                                                            |..|                               |..|
                                                                                            |..|===============================|..|
                                                                                            |..|                               |..|
                                                                                            |..|                               |..|
                                                                                            |..|                               |..|
                                                                                            |..|                               |..|
                                                                                            |..|                               |..|
                                                                                            |..|                               |..|
                                                                                            |..|                               |..|
                                                                                            |..|                               |..|
                                                                                            |..|                               |..|
                                                                                            |..|                               |..|
|..|___________________________________________________________________________________________________________________________|__|
|..|...........................................................................................................................|..|
|..|---------------------------------------------------------------------------------------------------------------------------|--|
|..|                               |                              |                               |                            |..|
|..|                               |                              |                               |                            |..|
|..|                               |                              |                               |                            |..|
|..|                               |                              |                               |                            |..|
|..|                               |                              |                               |                            |..|
|..|                               |                              |                               |                            |..|
|..|                               |                              |                               |                            |..|
|..|                               |                              |                               |                            |..|
|..|                               |                              |                               |                            |..|
|..|                               |                              |                               |                            |..|
|..|__________________________________________________________________________________________________________________________/.../
|.................................................................................................................................|
\_________________________________________________________________________________________________________________________________/
