________________________________________________________________________________________________________________________________
................................................................................................................................
________________________________________________________________________________________________________________________________
                               |                               |                               |                               |
                               |                               |                               |                               |
                               |                               |                               |                               |
                               |                               |                               |                               |
                               |                               |                               |                               |
                               |                               |                               |                               |
                               |                               |                               |                               |
                               |                               |                               |                               |
                               |                               |                               |                               |
                               |                               |                               |                               |
================================================================================================================================
================================================================================================================================
                               |                               |                               |                               |
                               |                               |                               |                               |
                               |                               |                               |                               |
                               |                               |                               |                               |
                               |                               |                               |                               |
                               |                               |                               |                               |
                               |                               |                               |                               |
                               |                               |                               |                               |
                               |                               |                               |                               |
                               |                               |                               |                               |
________________________________________________________________________________________________________________________________
................................................................................................................................
________________________________________________________________________________________________________________________________
